0000000000000000000000000000
0000000000000000000000000000
0000000000000000000000000000
1111111111111111111111111111
1____________11____________1
1_1111_11111_11_11111_1111_1
1_1001_10001_11_10001_1001_1
1_1111_11111_11_11111_1111_1
1__________________________1
1_1111_11_11111111_11_1111_1
1_1111_11_11111111_11_1111_1
1______11____11____11______1
111111_11111_11_11111_111111
000001_11111_11_11111_100000
000001_11__________11_100000
000001_11_11100111_11_100000
111111_11_1p0000o1_11_111111
t_________10000001_________t
111111_11_100000r1_11_111111
000001_11_11111111_11_100000
000001_11__________11_100000
000001_11_11111111_11_100000
111111_11_11111111_11_111111
1____________11____________1
1_1111_11111_11_11111_1111_1
1_1111_11111_11_11111_1111_1
1___11_______s_*_____b11___1
111_11_11_11111111_11_11_111
111_11_11_11111111_11_11_111
1______11____11____11______1
1_1111111111_11_1111111111_1
1_1111111111_11_1111111111_1
1__________________________1
1111111111111111111111111111
0000000000000000000000000000
0000000000000000000000000000